1 1 1 1 1 1 2 1 1 1 1 1 1 1 1 1 1 1 1 1 1 1 1 1 1 1 1 37 32 32 32 38 1 1 1 1 1 1 1 1 1 1 1 1 1 1 1 1 1 1
1 1 1 1 1 1 2 2 1 1 1 2 2 1 2 2 2 2 1 2 1 1 1 1 1 1 1 39 40 43 32 38 1 1 1 1 1 1 1 1 1 1 1 1 1 1 1 1 1 1
1 2 1 2 1 1 2 2 2 1 1 1 2 2 1 1 1 1 2 1 2 2 1 1 1 1 1 1 1 37 33 44 35 36 1 1 1 1 1 1 1 1 1 1 1 1 1 1 1 1
1 1 1 1 1 1 1 1 1 2 2 1 2 2 1 1 1 1 1 1 2 2 2 1 1 1 1 1 1 37 32 33 32 38 1 1 1 1 1 1 1 1 1 1 1 1 1 1 1 1
1 1 2 1 1 2 1 1 2 1 1 1 2 1 1 2 2 2 1 1 1 1 2 1 1 2 2 1 1 39 43 33 32 38 1 1 1 1 1 1 1 1 1 1 1 1 1 1 1 1
1 1 1 1 1 2 2 1 1 1 1 1 2 1 1 1 1 2 2 1 1 1 1 1 1 1 1 1 1 1 37 33 33 38 1 1 1 1 1 1 1 1 1 1 1 1 1 1 1 1
1 1 1 1 2 1 1 2 1 2 1 1 1 1 2 2 2 1 1 2 1 1 1 2 1 1 1 1 1 1 37 32 32 38 1 1 1 1 1 1 1 1 1 1 1 1 1 1 1 1
10 10 13 1 1 1 1 1 1 1 1 47 47 47 47 47 47 47 47 47 47 47 47 47 47 47 47 47 47 47 39 43 33 44 36 1 3 3 3 3 3 1 1 1 1 1 1 1 1 1
3 3 9 10 10 10 10 10 10 10 13 47 1 1 1 1 1 1 1 1 1 1 1 1 2 1 1 1 1 1 1 39 43 32 44 36 3 3 1 1 1 1 1 1 1 1 1 1 1 1
3 3 3 3 3 3 3 3 3 3 9 49 10 10 10 10 10 10 10 10 10 10 10 10 10 10 10 13 1 1 2 1 39 43 33 44 35 35 35 35 35 35 35 35 35 35 35 35 35 35
3 3 3 3 3 3 3 3 3 3 3 50 3 3 3 3 3 3 3 3 3 3 3 3 3 3 3 9 10 10 10 13 1 37 32 32 32 33 32 32 33 32 32 32 32 32 32 32 32 32
5 6 3 3 3 3 3 3 3 3 3 50 3 3 3 3 3 3 3 3 3 3 3 3 3 3 3 3 3 3 3 9 13 39 40 43 32 33 33 33 33 32 33 33 32 32 33 32 32 32
1 14 5 5 5 5 5 5 5 5 5 48 5 5 5 5 5 5 5 5 5 5 5 5 5 6 3 3 3 3 3 3 9 10 13 39 43 32 32 33 33 32 32 33 33 32 32 32 32 32
1 1 2 2 2 1 2 2 2 2 1 47 2 1 1 2 1 1 1 1 2 2 1 1 1 14 5 5 5 6 3 3 3 3 9 13 39 40 40 40 40 43 32 32 32 32 33 33 32 32
1 1 1 1 1 2 2 2 2 2 1 47 1 1 1 1 1 1 1 1 1 1 2 2 1 1 1 1 1 14 6 3 3 3 3 7 1 1 47 1 1 39 40 40 40 40 40 40 43 32
1 1 1 1 1 1 1 1 1 1 1 47 1 12 10 10 10 10 10 10 10 10 10 10 13 2 1 1 1 1 14 5 6 3 3 9 13 1 47 1 1 1 1 1 1 1 1 1 39 40
1 1 1 1 1 1 1 1 1 1 2 47 12 11 3 3 3 3 3 3 3 3 3 3 7 1 1 2 1 1 1 1 8 3 3 3 7 1 47 2 1 1 1 2 2 1 1 1 1 1
1 1 1 2 2 1 1 1 1 1 1 47 8 3 3 3 3 3 3 3 3 3 3 3 9 10 13 1 1 1 1 1 14 6 3 3 7 1 47 1 2 1 1 1 2 2 1 1 1 1
1 1 2 2 2 2 1 1 1 1 1 47 8 3 3 3 3 3 3 3 3 3 3 3 3 3 9 13 2 1 2 1 1 8 3 3 7 1 47 1 2 2 2 1 1 1 1 2 2 1
1 1 2 2 1 2 1 1 1 1 1 47 8 3 3 3 3 3 3 3 3 3 3 3 3 3 3 7 1 2 2 1 1 8 3 3 7 1 47 1 2 1 1 1 1 1 1 1 2 2
1 1 1 1 1 2 1 1 1 1 1 47 8 3 3 3 3 3 3 3 3 3 3 3 3 3 3 7 1 1 2 1 1 8 3 3 7 1 47 1 2 2 2 2 2 2 1 1 2 1
1 1 1 2 2 2 2 1 1 1 1 47 8 3 3 3 3 3 3 3 3 3 3 3 3 3 3 7 1 1 1 2 1 8 3 3 7 1 47 1 1 2 2 1 1 2 2 2 2 2
1 1 2 1 1 1 1 1 1 1 1 47 8 3 3 3 3 3 3 3 3 3 3 3 3 3 3 7 1 1 1 2 1 8 3 3 7 1 47 1 1 1 2 1 2 2 2 1 1 1
1 1 2 2 1 1 1 1 1 1 1 47 8 3 3 3 3 3 3 3 3 3 3 3 3 3 4 15 2 1 1 1 1 8 3 3 7 1 47 1 1 1 2 2 1 2 1 1 1 1
1 1 1 1 1 2 2 2 1 2 1 47 8 3 3 3 3 3 3 3 3 3 3 3 4 5 15 12 10 10 10 10 10 11 3 3 7 1 47 2 2 2 1 1 1 1 1 2 2 2
1 1 1 1 1 1 1 1 1 2 1 47 8 3 3 3 3 3 3 3 3 4 5 5 15 12 10 11 3 3 3 3 3 3 3 4 1 1 47 1 2 2 1 1 1 1 1 1 1 1
1 1 2 1 1 1 2 2 2 2 1 47 14 5 5 5 5 5 5 5 5 15 1 12 10 11 3 3 3 3 4 5 5 5 5 15 1 1 47 1 1 1 1 1 34 35 35 35 35 35
1 1 1 2 2 1 1 1 1 2 1 47 1 1 1 1 1 1 2 1 2 1 12 11 3 3 3 3 4 5 15 1 2 1 2 2 2 1 34 35 35 35 35 35 45 32 33 33 32 32
1 1 1 1 1 2 1 2 2 1 2 47 1 1 1 12 10 10 10 10 10 10 11 3 3 3 3 4 15 2 1 1 2 1 34 35 35 35 45 32 33 33 33 32 32 33 32 32 42 40
1 1 1 1 1 1 1 1 1 2 2 47 1 12 10 11 3 3 3 3 3 3 3 3 3 3 4 15 1 1 1 34 35 35 45 42 40 40 40 40 40 40 40 40 40 40 40 40 41 1
1 1 2 2 2 2 1 1 1 1 1 47 1 8 3 3 3 3 3 3 3 3 3 3 3 3 7 2 1 34 35 45 33 42 40 41 1 1 47 1 1 1 1 1 1 1 1 1 1 1
1 1 2 2 2 1 1 1 1 1 1 47 12 11 3 3 3 4 5 6 3 3 3 3 3 3 7 2 34 45 33 42 40 41 1 1 1 1 47 1 1 1 1 1 1 1 1 1 1 1
1 2 1 1 2 2 1 1 1 1 1 47 8 3 3 3 4 15 1 1 5 5 5 6 3 3 9 13 39 40 40 41 1 1 1 1 1 1 47 1 1 2 1 2 1 2 2 2 1 1
1 1 1 1 1 2 2 2 1 1 1 47 8 3 3 4 15 34 35 35 35 35 36 8 3 3 3 9 10 13 1 1 1 1 1 1 1 2 47 1 1 2 1 2 2 2 2 2 1 1
1 1 1 1 1 2 1 2 1 1 1 47 8 3 3 7 34 45 32 32 32 32 38 8 3 3 3 3 3 7 1 1 2 2 1 1 2 1 47 2 1 1 1 1 1 2 2 2 1 1
1 2 2 2 2 2 1 2 1 1 1 47 8 3 3 7 37 32 33 32 32 33 38 8 3 3 4 6 3 7 1 1 1 1 1 1 2 1 47 2 2 2 1 1 1 1 1 1 1 1
1 1 1 1 2 1 1 1 1 1 1 47 8 3 3 7 39 43 32 33 32 42 41 8 3 3 9 11 3 7 2 2 1 1 1 2 1 1 47 1 1 1 1 2 1 2 1 1 1 1
1 2 2 1 1 1 1 1 2 1 1 47 8 3 3 9 13 39 40 40 40 41 12 11 3 3 3 3 3 9 10 10 10 10 10 10 10 10 49 10 10 10 10 10 10 10 10 10 10 10
1 1 2 2 2 2 1 2 1 2 1 47 14 6 3 3 9 10 10 10 10 10 11 3 3 3 3 3 3 3 3 3 3 3 3 3 3 3 50 3 3 3 3 3 3 3 3 3 3 3
1 1 2 2 2 2 1 2 2 2 2 47 1 14 6 3 3 3 3 3 3 3 3 3 3 3 3 3 3 3 3 3 3 3 3 3 3 3 50 3 3 3 3 3 3 3 3 3 3 3
1 1 1 2 2 2 2 2 1 1 2 47 2 1 14 6 3 3 3 3 3 3 3 3 4 5 5 5 5 5 5 5 5 5 5 5 5 5 48 5 5 5 5 5 5 5 5 5 5 5
1 2 1 2 2 2 1 1 1 1 2 47 2 1 2 14 5 5 5 5 5 5 5 5 15 2 2 2 1 1 1 2 2 1 1 2 2 2 2 1 1 2 1 1 1 1 1 1 2 1
2 1 1 2 2 1 1 1 1 1 1 47 47 47 47 47 47 47 47 47 47 47 47 47 47 47 47 47 47 47 47 47 47 47 47 47 47 47 47 1 1 1 1 2 1 1 2 2 2 1
2 1 1 1 1 1 1 1 2 2 2 1 2 2 1 1 2 2 2 2 2 2 2 2 2 1 1 2 1 2 2 1 1 1 1 1 1 1 1 1 1 2 2 1 1 1 2 1 1 1 
2 1 1 2 1 2 1 2 2 2 2 1 2 1 1 1 1 2 1 1 2 2 2 2 1 2 2 2 2 2 2 1 1 2 2 1 1 2 1 1 1 1 2 1 1 2 1 1 2 2 
1 2 2 2 1 2 2 2 1 1 2 1 1 1 1 1 1 2 1 1 2 2 1 2 2 1 1 2 2 2 1 1 2 1 1 2 2 1 1 2 2 2 2 2 2 1 1 1 1 2 
1 2 1 1 1 2 1 2 2 2 1 1 1 1 1 1 1 1 1 2 2 1 1 1 1 2 2 2 2 2 1 1 2 1 2 2 1 1 1 1 2 1 1 2 2 1 1 2 1 1 
1 2 1 1 1 2 2 2 1 2 1 1 1 2 2 1 2 1 1 1 2 2 2 1 1 1 1 2 2 2 1 1 1 1 1 1 1 2 1 1 1 1 1 1 1 1 1 2 1 1 
1 2 2 1 1 1 1 1 1 1 2 1 1 1 1 1 1 1 2 1 2 2 2 2 2 1 2 2 1 1 1 1 1 1 1 1 1 1 1 1 1 1 1 1 1 1 1 1 1 1 
1 1 2 2 2 1 1 1 1 1 1 1 1 1 1 2 1 2 2 2 2 1 1 1 2 2 2 2 2 2 1 1 1 1 1 1 1 1 1 1 1 1 1 1 1 1 1 1 1 1 
