21 21 21 21 21 21 21 21 21 21 21 21 21 21 21 21 21 21 21 21 21 21 21 21 21 21 21 21 21 21 21 21 21 21 21 21 21 21 21 21 21 21 21 21 21 21 21 21 21 21 
21 21 21 21 21 21 21 21 21 21 21 21 21 21 21 21 21 21 21 21 21 21 21 21 21 21 21 21 21 21 21 21 21 21 21 21 21 21 21 21 21 21 21 21 21 21 21 21 21 21 
21 21 21 21 21 21 21 21 21 21 21 21 21 21 21 21 21 21 21 21 21 21 21 21 21 21 21 21 21 21 21 21 21 21 21 21 21 21 21 21 21 21 21 21 21 21 21 21 21 21 
21 21 21 21 21 21 21 21 21 21 21 21 21 21 21 21 21 21 21 21 21 21 21 21 21 21 21 21 21 21 21 21 21 21 21 21 21 21 21 21 21 21 21 21 21 21 21 21 21 21 
21 21 21 21 21 21 21 21 21 21 21 21 21 21 21 21 21 21 21 21 21 21 21 21 21 21 21 21 21 21 21 21 21 21 21 21 21 21 21 21 21 21 21 21 21 21 21 21 21 21 
21 21 21 21 21 21 21 21 21 21 21 21 21 21 21 21 21 21 21 21 21 21 21 21 21 21 21 21 21 21 21 21 21 21 21 21 21 21 21 21 21 21 21 21 21 21 21 21 21 21 
23 23 23 23 23 23 23 23 23 23 23 23 23 23 23 23 23 23 23 23 23 23 23 23 21 21 21 21 23 23 23 23 23 23 23 23 23 23 23 23 23 23 23 23 23 23 23 23 23 23 
31 31 31 31 31 31 31 31 31 31 31 31 31 31 31 31 31 31 31 31 31 31 31 31 30 30 30 30 31 31 31 31 31 31 31 31 31 31 31 31 31 31 31 31 31 31 31 31 31 31 
31 31 31 31 31 31 31 31 31 31 31 31 31 31 31 31 31 31 31 31 31 31 31 31 30 30 30 30 31 31 31 31 31 31 31 31 31 31 31 31 31 31 31 31 31 31 31 31 31 31
21 21 21 21 21 21 21 21 31 31 31 31 21 21 21 21 21 21 21 21 21 21 21 21 21 21 21 21 21 21 21 21 21 21 21 21 21 21 31 31 31 31 21 21 21 21 21 21 21 21
21 21 21 21 21 21 21 21 31 31 31 31 21 21 21 21 21 21 21 21 21 21 21 21 21 21 21 21 21 21 21 21 21 21 21 21 21 21 31 31 31 31 21 21 21 21 21 21 21 21
21 21 21 21 21 21 21 21 46 46 46 46 21 21 21 21 21 21 21 21 21 21 21 21 21 21 21 21 21 21 21 21 21 21 21 21 21 21 46 46 46 46 21 21 21 21 21 21 21 21
21 21 21 21 21 21 21 21 46 46 46 46 21 21 21 21 21 21 21 21 21 21 21 21 21 21 21 21 21 21 21 21 21 21 21 21 21 21 46 46 46 46 21 21 21 21 21 21 21 21
21 21 21 21 21 21 21 21 46 46 46 46 21 21 21 21 21 21 21 21 21 21 21 21 21 21 21 21 21 21 21 21 21 21 21 21 21 21 46 46 46 46 21 21 21 21 21 21 21 21
21 21 21 21 21 21 21 21 31 31 31 31 21 21 21 21 21 21 21 21 21 21 21 21 21 21 21 21 21 21 21 21 21 21 21 21 21 21 31 31 31 31 21 21 21 21 21 21 21 21
21 21 21 21 21 21 21 21 31 31 31 31 21 21 21 21 21 21 21 21 29 23 23 23 28 21 21 29 23 23 23 28 21 21 21 21 21 21 31 31 31 31 21 21 21 21 21 21 21 21
21 21 21 21 21 21 21 21 31 31 31 31 23 23 23 23 23 23 23 23 20 31 31 31 30 30 30 30 31 31 31 18 23 23 23 23 23 23 31 31 31 31 21 21 21 21 21 21 21 21
21 21 21 21 21 21 21 21 31 31 31 31 31 31 31 31 31 31 31 31 31 31 31 31 30 30 30 30 31 31 31 31 31 31 31 31 31 31 31 31 31 31 21 21 21 21 21 21 21 21
21 21 21 21 21 21 21 21 31 31 31 31 31 31 31 31 31 31 31 31 31 31 31 31 30 30 30 30 31 31 31 31 31 31 31 31 31 31 31 31 31 31 21 21 21 21 21 21 21 21
21 21 21 21 21 21 21 21 31 31 31 31 31 31 31 31 31 31 31 31 31 21 21 21 30 30 30 30 21 21 21 31 31 31 31 31 31 31 31 31 31 31 21 21 21 21 21 21 21 21
21 21 21 21 21 21 21 21 31 31 31 31 22 22 22 22 22 22 22 22 22 21 21 21 21 21 21 21 21 21 21 21 21 21 21 21 21 21 31 31 31 31 21 21 21 21 21 21 21 21
21 21 21 21 21 21 21 21 31 31 31 31 21 21 21 21 21 21 21 21 21 17 19 23 23 28 29 23 23 17 19 21 21 21 21 21 21 21 31 31 31 31 21 21 21 21 21 21 21 21
21 21 21 21 21 21 21 21 31 31 31 31 21 21 21 21 21 21 21 21 21 18 20 32 32 24 25 33 32 18 20 21 21 21 21 21 21 21 31 31 31 31 21 21 21 21 21 21 21 21
21 21 21 21 21 21 21 21 31 31 31 31 21 21 21 21 21 21 21 21 21 25 32 32 33 24 25 32 32 33 24 21 21 21 21 21 21 21 31 31 31 31 21 21 21 21 21 21 21 21
21 21 21 21 21 21 21 21 31 31 31 31 21 21 21 21 21 21 21 21 21 25 33 32 17 30 30 19 32 32 24 21 21 21 21 21 21 21 31 31 31 31 21 21 21 21 21 21 21 21
21 21 21 21 21 21 21 21 46 46 46 46 21 21 21 21 21 21 21 21 21 26 22 22 27 21 21 26 22 22 27 21 21 21 21 21 21 21 46 46 46 46 21 21 21 21 21 21 21 21
21 21 21 21 21 21 21 21 46 46 46 46 21 21 21 21 21 21 21 21 21 29 23 23 28 21 21 29 23 23 28 21 21 21 21 21 21 21 46 46 46 46 21 21 21 21 21 21 21 21
21 21 21 21 21 21 21 21 31 31 31 31 21 21 21 21 21 21 21 21 21 25 32 33 18 21 21 20 32 33 24 21 21 21 21 21 21 21 31 31 31 31 21 21 21 21 21 21 21 21
21 21 21 21 21 21 21 21 31 31 31 31 21 21 21 21 21 21 21 21 21 25 32 32 32 24 25 32 32 32 24 21 21 21 21 21 21 21 31 31 31 31 21 21 21 21 21 21 21 21
21 21 21 21 21 21 21 21 31 31 31 31 21 21 21 21 21 21 21 21 21 26 19 32 33 24 25 33 32 17 27 21 21 21 21 21 21 21 31 31 31 31 21 21 21 21 21 21 21 21
21 21 21 21 21 21 21 21 31 31 31 31 21 21 21 21 21 21 21 21 21 21 26 22 22 30 30 22 22 27 21 21 21 21 21 21 21 21 31 31 31 31 21 21 21 21 21 21 21 21
21 21 21 21 21 21 21 21 31 31 31 31 21 21 21 21 21 21 21 21 21 21 21 21 21 21 21 21 21 21 21 21 21 21 21 21 21 21 31 31 31 31 21 21 21 21 21 21 21 21
21 21 21 21 21 21 21 21 31 31 31 31 21 21 21 21 21 21 21 21 21 21 21 21 23 28 29 23 21 21 21 21 21 21 21 21 21 21 31 31 31 31 21 21 21 21 21 21 21 21
31 31 31 31 31 31 31 31 31 31 31 31 31 31 31 31 31 31 31 31 31 31 31 31 32 24 25 33 31 31 31 31 31 31 31 31 31 31 31 31 31 31 31 31 31 31 31 31 31 31
22 22 22 22 22 22 22 22 22 22 22 22 22 22 22 22 22 22 22 22 22 22 19 31 33 24 25 32 31 17 22 22 22 22 22 22 22 22 22 22 21 21 22 22 22 22 22 22 22 22 
31 31 31 31 31 31 31 31 31 31 31 31 31 31 31 31 31 31 31 31 31 31 31 31 32 24 25 33 31 31 31 31 31 31 31 31 31 31 31 31 31 31 31 31 31 31 31 31 31 31 
31 31 31 31 31 31 31 31 31 31 31 31 31 31 31 31 31 31 31 31 31 31 31 31 33 24 25 32 31 31 31 31 31 31 31 31 31 31 31 31 31 31 31 31 31 31 31 31 31 31 
31 31 31 31 31 31 31 31 31 31 31 31 31 31 31 31 31 31 31 31 31 31 31 31 32 24 25 33 31 31 31 31 31 31 31 31 31 31 31 31 31 31 31 31 31 31 31 31 31 31 
31 31 31 31 31 31 31 31 31 31 31 31 31 31 31 31 31 31 31 31 31 31 31 17 22 30 30 22 19 31 31 31 31 31 31 31 31 31 31 31 31 31 31 31 31 31 31 31 31 31 
1 1 2 1 1 1 1 2 2 1 1 1 1 1 1 1 2 1 1 1 1 1 8 3 3 3 3 3 3 7 2 2 1 2 1 1 2 1 2 1 1 2 1 1 1 1 2 1 1 1 
1 2 2 1 1 1 2 1 1 2 1 2 1 1 2 1 1 1 1 2 1 2 14 6 3 3 3 4 5 15 1 2 2 2 2 1 1 2 2 1 1 1 1 1 1 1 1 1 1 1 
1 1 1 1 2 1 1 1 2 2 1 2 2 1 1 2 1 2 1 1 1 2 1 8 3 3 3 9 2 1 2 1 1 2 2 1 2 1 1 1 2 2 1 1 1 2 1 2 2 1 
1 2 2 2 1 1 2 1 2 2 1 1 2 1 2 2 1 2 2 2 2 2 1 14 6 3 3 3 7 1 2 2 1 1 1 2 1 1 2 2 1 2 2 2 1 1 1 1 2 1 
1 1 1 2 1 1 2 2 2 2 2 1 1 2 2 2 1 2 1 2 1 1 2 2 8 3 3 3 7 1 2 2 1 2 2 1 2 2 1 1 1 1 1 1 1 2 1 1 2 1 
1 1 1 1 2 2 1 1 1 2 1 2 1 2 2 2 1 1 2 2 1 1 1 1 8 3 3 3 7 2 1 1 1 2 2 2 2 1 1 1 2 1 1 1 1 2 2 1 1 1 
1 2 1 2 1 1 1 1 2 2 2 2 2 1 2 1 1 1 2 2 1 1 2 12 11 3 3 4 15 1 1 1 1 2 1 2 1 1 2 2 1 2 2 1 1 1 2 1 1 1 
1 1 1 2 1 1 1 1 2 1 1 1 2 1 1 2 2 2 2 1 1 2 12 11 3 3 3 9 13 1 2 1 2 2 2 1 1 1 2 2 2 2 1 1 2 1 2 1 1 2 
1 2 2 2 1 1 1 1 1 2 2 2 2 1 2 2 1 2 1 2 2 2 8 3 3 3 3 3 7 1 2 2 1 2 2 2 2 2 2 2 1 1 1 1 2 1 2 1 1 2 
1 2 2 2 2 2 2 1 1 2 2 2 2 2 2 2 2 2 2 2 2 2 8 3 3 3 3 4 1 1 1 2 2 1 1 1 2 2 1 1 2 1 2 2 1 2 2 1 1 2 
2 2 1 1 1 1 1 1 2 2 2 1 1 2 2 1 1 1 2 2 1 2 2 3 3 3 3 7 1 1 1 1 2 2 2 2 2 2 2 1 1 1 1 2 1 1 1 1 1 1 
